F 139,99,255
C 171,154,120

NO textures/texture_1.xpm
SO textures/texture_2.xpm
WE textures/texture_3.xpm
EA textures/texture_4.xpm

111111111 11111111111
100000001 100000000011111
10000100111011100000000001
1000010100000010000011111
100001111000111000001
10000001S  0100000001
100000000000111011101
10000000000000111 101
11111111111111111 111