F 139,99,255
C 171,154,120

NO textures/texture_1.xpm
SO textures/texture_2.xpm
WE textures/texture_3.xpm
EA textures/texture_4.xpm

11111
10E01
11111