F 200,200,200
C 200,200,200

NO textures/test/north.xpm
SO textures/test/south.xpm
WE textures/test/west.xpm
EA textures/test/east.xpm

11111
10001
10001
10Q01
10001
10001
11001
10001
10001
10001
10001
10001
11111
