F 139,99,255
C 171,154,120

NO textures/texture_1.xpm
SO textures/texture_2.xpm
WE textures/texture_3.xpm
EA textures/texture_4.xpm

111111111111111111111
1000000000000000000011111
10000100000011100000000001
10000101000000100W0011111
100001111000111000001
100000010000100000001
100000000000111000001
100000000000000000001
111111111111111111111