F 139,99,255
C 171,154,120

NO textures/wall.xpm
SO textures/wall.xpm
WE textures/wall.xpm
EA textures/wall.xpm

111111111111111111111
1000000000000000000011111
10000100000011100000000001
1000010100000010000011111
100001111000111000001
100000010000100000001
100000000N00111000001
100000000000000000001
111111111111111111111