NO textures/texture_1.xpm
SO textures/texture_2.xpm
WE textures/texture_3.xpm
EA textures/texture_4.xpm

F 100,100,0
C 204,229,255

11111111
100N0101 111
10001001 101
10000001 111
11111111

1