NO textures/wall.xpm
SO textures/wall.xpm
WE textures/wall.xpm
EA textures/wall.xpm

F 20,20,20
C 200,200,200

1111111111111111111
1000000000000000001
100000000000000000011111111
10000000000E000000000000001
100000000000000000000000001
100000000000000000000111111
1111111111111111111111
